NO./img/biblio.xpm                                          
SO./img/biblio.xpm
WE./img/biblio.xpm
EA./img/biblio.xpm
F150,150,150
C255,255,255

111111111111111111111111111111111111111111111111111111111111111
100000000000000000000000000000000000010000000000000000000000001
100000000000000000000000000000000000000000000000000000000000001
100000000000000100000000000000000010000000000000000100000000001
100000000000000000000000000000000000000000000000000000000000001
100001000000000000000000000000000000000000000000000000000000001
100000000000000100000000000000000010000000000000000000000000001
100000000000000000000000000000000000000000000000000000000000001
100000000000000000000000000000000000000000000000000100000000001
100000000000100000000000000000100000000000000000000000000000001
100000000000000000000000000000000000000000000000000000000000001
100000000000100000001111111111111111111111111111111111111111101
100000000000000000001                                       101
100111111111111111111                                       101
1001                                                        101
1001                                                        101
1001                                                        101
100111111111111111111111111111111111111111111111111111111111101
1N0000000000000000000000000000000000000000000000000000000000001
100111111111111111111111111111111111111111111111111111111111111
1111