NO./img/red.xpm                                               
SO./img/green.xpm
WE./img/yellow.xpm
EA./
F220,100,1
C225,30,1

111111111111111111111
100000000000000000001
100000000000000000001
100000000000000000001
100000000000000000001
100000000000000000001
100000000000000000001
100000000000000000001
1000000000N0000000001
100000000000000000001
100000000000000000001
100000000000000000001
100000000000000000001
100000000000000000001
100000000000000000001
111111111111111111111