                  NO./img/ground.xpm                                               

SO./img/wall.xpm
WE./img/player_up.xpm            
                          EA./textur
F220,100,1
C225,30,1


    111 111111111111
   1111110010000001111
   111111111111111
                   
   111111111111111      
   100011100001101
  100000100000011111
 1N000010000001000001   
  100100000011100111
  101 1000001 1001
  111 11111111 1111