NO./img/biblio.xpm                                               
SO./img/biblio.xpm
WE./img/biblio.xpm
EA./img/biblio.xpm
F220,100,1
C220,100,1

111111111111111111111
111000000000000000001
100000000000000000001
100000000000000000001
1000000000000000000011111111
1000001000000010000000000001
1000000000000000000000000001
1000000001000000000000000001
100000000S000000000000000001
1000000000000000000000000001
1000000000000000000000000001
1000000000000000000011111111
100000000000000000001
100000000000000000001
100000000000000000001
100000000000000000001
100000000000000000001
100000000000000000001
100000000000000000001
100000000000000000001
100000000000000000001
100000000000000000001
100000000000000000001
100000000000000000001
100000000000000000001
100000000000000000001
100000000000000000001
100000000000000000001
100000000000000000001
100000000000000000001
100000000000000000001
100000000000000000001
100000000000000000001
111111111111111111111
