NO./img/biblio.xpm                                          
SO./img/biblio.xpm
WE./img/biblio.xpm
EA./img/biblio.xpm
F150,150,150
C255,255,255

111111