NO./img/red.xpm
SO./img/biblio.xpm
WE./img/green.xpm
EA./img/yellow.xpm

F0,0,0
C225,30,0

         1111111111111111111111111
         1000000000110000000000001
         1011000001110000000000001
         1001000000000000000000001
111111111011000001110000000000001
100000000011000001110111111111111
11110111111111011100000000001
11110111111111011101010010001
11000000110101011100000010001
10000000000000001100000010001
10000000001000001101010010001
11000001110101011111011110S01
11110111 1110101 101111010001
11111111 1111111 111111111111