NO./img/biblio.xpm                                          
SO./img/biblio.xpm
WE./img/biblio.xpm
EA./img/biblio.xpm
F150,150,150
C255,255,255

1111111111111111111111111
1000000000000000000000001
1010101010101010101010101
1000000000000000000000001
1010101010101010101010101
1000000000000000000000001
1010101010101010101010101
100000000000N000000000001
1010101010101010101010101
1000000000000000000000001
1010101010101010101010101
1000000000000000000000001
1010101010101010101010101
1000000000000000000000001
1010101010101010101010101
1000000000000000000000001
1010101010101010101010101
1111111111111111111111111