NO./img/biblio.xpm                                          
SO./img/biblio.xpm
WE./img/biblio.xpm
EA./img/biblio.xpm
F150,150,150
C255,255,255



111111111111111    111111111111111111111111111111111111111111111111111         111111111111111111111111111111111111111111111111111111111111111111111111111111111111111111111111111111111
1000000N0000001    100000000000000000000000000000000000000000000000001         100000000000000000000000000000000000000000000000000000000000000000000000000000000000000000000000000000001
100000000000001    101010101010101010101010101010101010101010101010101         100000000000000000000000000000000000000000000000000000000000000000000000000000000000000000000000000000001
100000000000001    101010101010101010101010101010101010101010101010101         100000000000000000000000000000000000000000000000000000000000000000000000000000000000000000000000000000001
111111111111001    101010101010101010101010101010101010101010101010101         100000000000000000000000000000000000011111111111111111111111110000000000000000000000000000000000000000001
           1001    101010101010101010101010101010101010101010101010101         100000000000000000000000000000000000011111111111111111111111110000000000000000000000000000000000000000001
           1001    100000000000000000000000000000000000000000000000001         100000000000000000000000000000000000011111111111111111111111110000000000000000000000000000000000000000001
           1001    101111111111111111111111111111111011111111111111111         100000000000000000000000000000000000011111111111111111111111110000000000000000000000000000000000000000001
           1001    101                             101                         101000000000000000000000000000000000000000000000000000000000000000000000000000000000000000000000000000001
           1001    101111111111111                 101                         101000000000000000000000000000000000000000000000000000000000000000000000000000000000000000000000000000001
111111111111001    100000000000001                 101                         101000000000000000000000000000000000000000000000000000000000000000000000000000000000000000000000000000001
100000000000001    111111111111001                 101                         101000000000000000000000000000000000001111111111111111111111111000000000000000000000000000000000000000001
100000000000001               1001                 101                         101000000000000000000000000000000000001111111111111111111111111000000000000000000000000000000000000000001
100000000000001               1001                 101                         101000000000000000000000000000000000001111111111111111111111111000000000000000000000000000000000000000001
100000000000001               1001                 101                         101000000000000000000000000000000000001111111111111111111111111000000000000000000000000000000000000000001
100000000000001               1001                 101                         101000000000000000000000000000000000000000000000000000000000000000000000000000000000000000000000000000001
100000000000001               1001                 101                         101000000000000000000000000000000000000000000000000000000000000000000000000000000000000000000000000000001
1111111111110011111111111111111101                 1011111111111111111111111111101000000000000000000000000000000000000000000000000000000000000000000000000000000000000000000000000000001
           10000000000000000000001                 1000000000000000000000000000001000000000000000000000000000000000000000000000000000000000000000000000000000000000000000000000000000001
           10000000000000000000001                 1000000000000000000000000000001000000000000000000000000000000000000000000000000000000000000000000000000000000000000000000000000000001
           11111111111111111111111                 1111111111111111111111111111111111111111111111111111111111111111111111111111111111111111111111111111111111111111111111111111111111111

















