NO./img/red.xpm
SO./img/biblio.xpm
WE./img/green.xpm
EA./img/yellow.xpm

F0,0,0
C225,30,0


11111111111111111
10000000000000001
10000000000000001
10000000000000001
10000000000000001
100000000N0000001
10000000000000001
10000000000000001
10000000000000001
10000000000000001
10000000000000001
10000000000000001
10000000000000001
10000000000000001
10000000000000001
10000000000000001
10000000000000001
10000000000000001
10000000000000001
10000000000000001
10000000000000001
10000000000000001
10000000000000001
10000000000000001
10000000000000001
10000000000000001
10000000000000001
10000000000000001
10000000000000001
10000000000000001
10000000000000001
11111111111111111